[grid]
    size: (22 x 22)
    encodings : WALL(W) PILLAR(P) DOOR(D)
    data: """
WWWWWWWWWWWWWWWWWWWWWW
W       P            W
W P PPPPP     P PPPP W
WPP P         P P    W
W     PPP     P P PPPW
W PPP P P     P P    W
W P   P P     P PPPP W
W PPPPP P PPPPP P    W
W       P       PPPPPW
W PPPPP P PPPPPPP   PW
W P     P      P  P  W
W P PPPPPPPPPPPP PPP W
W P  P         P   P W
WPPP P PPPPPPP PPP P W
W    P P P   P     P W
W PPPP P P P PPPPPPP W
W P    P P P P   P   W
W P P PP P P P P P PPW
W P   P  P P P P P   W
W P PPP PP P P P PPP W
W       P  P   P     W
WWWWWWWWWDWWWWWWWWWWWW
"""

[element]
	name: UvuvwevweOnyetevewveUgwembwemOsas
	player: true
	skin: BABA
	position: (10,1)
	health: 10

[element]
	name: Durendale
	skin: SWORD
	position: (3,1)
	kind: item
	damage: 15

[element]
	name: Waldo
	skin: CRAB
	position: (1, 2)
	kind: enemy
	health: 10
	zone: (1, 1) (5 x 3)
	behavior: agressive
	damage: 10