[grid]
    size: (22 x 22)
    encodings : WALL(W) PILLAR(P) DOOR(D)
    data: """
WWWWWWWWWWWWWWWWWWWWWW
W                    W
W                    W
W                    W
W                    W
W                    W
W                    W
W                    W
W                    W
W                    W
W                    W
W                    W
W                    W
W                    W
W                    W
W                    W
W                    W
W                    W
W                    W
W                    W
W                    W
WWWWWWWWWDWWWWWWWWWWWW
"""

[element]
	name: UvuvwevweOnyetevewveUgwembwemOsas
	player: true
	skin: BABA
	position: (10,1)
	health: 25

[element]
	name: Durendale
	skin: SWORD
	position: (3,1)
	kind: item
	damage: 15

[element]
	name: Waldo
	skin: CRAB
	position: (2, 2)
	kind: enemy
	health: 50
	zone: (1, 1) (5 x 3)
	behavior: agressive
	damage: 1

[element]
	name: Gram
	skin: SWORD
	position: (13,10)
	kind: item
	damage: 15